=S.....=
=.====.=
=.==S..=
=.=..=.=
=.====.=
=.S.=..=
