========================
=..........==..........=
=.====.===.==.===.====.=
=.====.===.==.===.====.=
=.====............====.=
=.====.===.==.===.====.=
=......===.==.===......=
======.==......==.======
======.==.====.==.======
======.==......==.======
======.==.====.==.======
=.........====.........=
=.=====.========.=====.=
=.=====.========.=====.=
=......................=
=.=====.========.=====.=
=.=====.========.=====.=
=......................=
=.===.============.===.=
=.===.============.===.=
=.===..............===.=
=.===.============.===.=
=......................=
========================