=......=
=.====.=
=.==...=
=.=..===
=.====.=
=...=..=
